BAAAAAADAAAAAAAa
AAAAAAADAAAAAAAb
AAAAAAADAAAAAAAc
AAAAAAADAAAAAAAd
AAAAAAADAAAAAAAe
AAAAAAADAAAAAAAf
AAAAAAADAAAAAAAg
AAAAAAADAAAAAAAh
AAAAAAADAAAAAAAi
AAAAAAADAAAAAAAj
1234567089:;<=>